xxxxxxx  xxxxxx  xxxxxx  xxxxxxx
xxx                            x
xxx                            x
xxx                            x
x       e                 e    x
x                              x
x                              x
                                
            e                   
x                              x
x                              x
x                              x
x                   xx     s   x
x           xxx     xx         x
x           xxxxxxxxxxxxxxxxxxxx
            xx                  
             x                  
x                              x
x                    PPPPPP    x
x                    pppppp    x
x            x       pppppp    x
x          xxx       pppppp    x
x          xxxx                x
              x                 
              x      e          
x             x                x
x             x        s       x
x      s      x                x
x             x                x
x             x                x
x             x                x
xxxxxxx  xxxxxx  xxxxxx  xxxxxxx