xxxxxxx  xxxxxx  xxxxxx  xxxxxxx
x             x  x             x
x             x  x             x
x             x  x             x
x             x  x             x
x    xxxxxxx  x  x  xxxxxxx    x
x    x                    x    x
     x                  s x     
     x                    x     
x    x                    x    x
x    x                    x    x
x    x                    x    x
x                              x
x                              x
xxxxxx                    xxxxxx
                                
                                
xxxxxx                    xxxxxx
x                              x
x                              x
x    x                    x    x
x    x                    x    x
x    x                    x    x
     x                    x     
     x s                  x     
x    x                    x    x
x    xxxxxxx  x  x  xxxxxxx    x
x             x  x             x
x             x  x             x
x             x  x             x
x             x  x             x
xxxxxxx  xxxxxx  xxxxxx  xxxxxxx