xxxxxxx  xxxxxx  xxxxxx  xxxxxxx
x                              x
x                              x
x    s         xx       s      x
x              xx              x
x              xx              x
x              xx              x
               xx               
               xx               
x         xxxxxxxxxxxxx        x
x         xxxxxxxxxxxxx        x
x              xx              x
x              xx   s          x
x              xx              x
x              xx   xx         x
               xx   xx          
               xx   xx          
x                   xx         x
x                   xx         x
x                   xx         x
x            xxxxxxxxxxxxxxx   x
x            xxxxxxxxxxxxxxx   x
x            xxxxxxxxx         x
             xxxxxxxxx          
             xxxxxxxxx          
x            xxxxxxxxx         x
x     xxxxxxxxxxxxxxxx         x
x            xxxxxxxxx         x
x                              x
x                     s        x
x                              x
xxxxxxx  xxxxxx  xxxxxx  xxxxxxx