xxxxxxx  xxxxxx  xxxxxx  xxxxxxx
x                              x
x    s                         x
x                              x
x                              x
x                              x
x                              x
                                
                                
x            xxxx  xxxx        x
x            x        x        x
x            x        x        x
x            x        x        x
x            x        x        x
x            x        xxxxxxxxxx
             x                  
             x                  
xxxxxxxxxxxxxx                 x
x                              x
x               e              x
x                              x
x                              x
x                              x
                                
                                
x                              x
x                              x
x                              x
x  e                    s      x
x                              x
x                              x
xxxxxxx  xxxxxx  xxxxxx  xxxxxxx