xxxxxxx  xxxxxx  xxxxxx  xxxxxxx
x222222  222222  222222  222222x
x222222         s        222222x
x22222222222222  22222222222222x
x22222222222222  22222222222222x
x22222222222222  22222222222222x
x22222222222222  22222222222222x
                                
                                
x22222222222222  22222222222222x
x22222222222222  22222222222222x
x22222222222222  22222222222222x
x2                            2x
x2                            2x
x2                            2x
                s               
                                
x2                            2x
x2                            2x
x22222222222222  22222222222222x
x22222222222222  22222222222222x
x22222222222222  22222222222222x
x22222222222222  22222222222222x
                                
                                
x22222222222222  22222222222222x
x22222222222222  22222222222222x
x22222222222222  22222222222222x
x22222222222222  22222222222222x
x222222                  222222x
x222222  222222  222222  222222x
xxxxxxx  xxxxxx  xxxxxx  xxxxxxx