xxxxxxx  xxxxxx  xxxxxx  xxxxxxx
x                              x
x   s                          x
x  xxx  xxxxxxxxxxxxxxxx  xxx  x
x  x                        x  x
x  x                        x  x
x                              x
                                
   x       i                x   
x  x                        x  x
x  x                        x  x
x  x                        x  x
x  x              i         x  x
x  x                        x  x
x  x                        x  x
   x      s                 x   
   x                        x   
x  x                        x  x
x  x                        x  x
x  x                        x  x
x  x                        x  x
x  x    i                   x  x
x  x                        x  x
   x                        x   
                        i       
x                              x
x  x                        x  x
x  x                        x  x
x  xxx  xxxxxxxxxxxxxxxx  xxx  x
x             s                x
x                              x
xxxxxxx  xxxxxx  xxxxxx  xxxxxxx